   </	__DELETE__
,	__DELETE__
...	__DELETE__
....	__DELETE__
.........	__DELETE__
]	__DELETE__
</	</
</	__DELETE__
1	__DELETE__
10× Chromium Single Cell 3′ v2 Reagent Kit	10× Chromium Single Cell 3′ v2 Reagent Kit
10× Chromium Single Cell 3′ v3 Reagent Kit	10× Chromium Single Cell 3′ v3 Reagent Kit
10× Genomics, Chromium Next GEM Single Cell 3' v3.1	Chromium Next GEM Single Cell 3' v3.1
10× Genomics, Chromium Next GEM Single Cell 5' v2	Chromium Next GEM Single Cell 5' v2
10x Chromium Single Cell 3′ v3	10x Chromium Single Cell 3′ v3
10X Genomics Chromium	Chromium Platform
10x Genomics Chromium Genome Sequencing Solution	Chromium Genome Library Kit
10X Genomics-Chromium system	Chromium Platform
10x Genomics, Chromium Next GEM Multiome	Chromium Next GEM Multiome
16S Metagenomic Sequencing Library Prep	16S Metagenomic Sequencing Library Prep
1D Ligation Sequencing Kit	1D Ligation Sequencing Kit
1D Ligation Sequencing Kit(Cat#SQK-LSK108)	1D Ligation Sequencing Kit(Cat#SQK-LSK108)
2	__DELETE__
2-step tailed PCR (Ex Taq HS)	2-step tailed PCR (Ex Taq HS)
2.5	__DELETE__
2x Platinum Multiplex PCR Master Mix	2X Platinum Multiplex PCR Master Mix
2X Platinum Multiplex PCR Master Mix	2X Platinum Multiplex PCR Master Mix
660W-Quad	__DELETE__
ABsolute QPCR Mix	ABsolute QPCR Mix
Accel-NGS Methyl-Seq DNA library Kit	Accel-NGS Methyl-Seq DNA Library Kit
Accel-NGS Methyl-Seq DNA Library Kit	Accel-NGS Methyl-Seq DNA Library Kit
ACCEL-NGS METHYL-SEQ DNA LIBRARY KIT ver3.0	Accel-NGS Methyl-Seq DNA Library Kit
Adns Test Prostate Cancer Panel AR-V7	Adns Test Prostate Cancer Panel AR-V7
Adns Test Prostate Cancer Panel AR-V7(Qiagen)	Adns Test Prostate Cancer Panel AR-V7
Affymetrix AXIOM 2.0 Reagent Kit	Axiom 2.0 Reagent Kit
Affymetrix Cytoscan HD kit	Cytoscan HD Kit
Affymetrix Genome-Wide Human SNP Assay Kit 6.0	Genome-Wide Human SNP Array 6.0 Kit
Affymetrix Genome-Wide Human SNP Nsp/Sty Assay Kit 6.0	Genome-Wide Human SNP Array 6.0 Kit
Agilent [SureSelect QXT Human All Exon v5]	Agilent [SureSelect QXT Human All Exon v5]
Agilent [SureSelect XT Human All Exon v5]	Agilent [SureSelect XT Human All Exon v5]
Agilent DNA labeling kit	Agilent DNA Labeling Kit
Agilent DNA Labeling Kit	Agilent DNA Labeling Kit
Agilent Haloplex HS custom kit	HaloPlex HS Custom Kit
Agilent Haloplex Target Enrichment	HaloPlex Target Enrichment
Agilent Low Input Quick Amp Labeling Kit, one-color	Low Input Quick Amp Labeling Kit
Agilent Quick-Amp Labeling Kit	Quick-Amp Labeling Kit
Agilent Sure Select XT	SureSelect XT
Agilent SureSelect Clinical Research panel v2	SureSelect Clinical Research Panel v2
Agilent SureSelect Human All Exon Kit v4	SureSelect Human All Exon V4
Agilent SureSelect Human All Exon Kit v5+ LincRNA	SureSelect Human All Exon V5 + lincRNA
Agilent SureSelect Human All Exon v.4	SureSelect Human All Exon V4
Agilent SureSelect Human All Exon V5 (50M) kit	SureSelect Human All Exon V5
Agilent SureSelect QXT Human All Exon v5	SureSelect QXT Human All Exon V5
Agilent SureSelect Strand Specific RNA Kit	SureSelect Strand Specific RNA Kit
Agilent SureSelect v.5 + lncRNA kit	SureSelect Human All Exon V5 + lincRNA
Agilent SureSelect V4-post	SureSelect Human All Exon V4
Agilent SureSelect XT custom kit	SureSelect XT Custom Kit
Agilent SureSelect XT Focused Exome target enrichment kit	SureSelect XT Focused Exome Kit
Agilent SureSelect XT Human All Exon v5	SureSelect XT Human All Exon V5
Agilent SureSelect XT Human All Exon V5	SureSelect XT Human All Exon V5
Agilent SureSelect XT Human All Exon V5+Reg	SureSelect XT Human All Exon V5
Agilent SureSelect-XT Low Input Reagent Kit	SureSelect XT Low Input Kit
Agilent SureSelectXT RNA Target Enrichment for Illumina Multiplexed Sequencing	SureSelect XT RNA Target Enrichment
Agilent V6 plus custom probes	SureSelect Human All Exon V6
Amplicon	Amplicon-based Method
Amplicon Sequencing	Amplicon-based Sequencing
AmpliSeq Custom DNA Panel for Illumina	AmpliSeq Custom Panel
AmpliSeq Custom Panel	AmpliSeq Custom Panel
AmpliSeq Library Plus for Illumina	AmpliSeq Library Plus for Illumina
AmpliSeq Library PLUS for illumina	AmpliSeq Library Plus for Illumina
AmpliTaq PCR Kit	AmpliTaq PCR Kit
AmpliTaq PCR kits	AmpliTaq PCR Kit
Arima	Arima
Arima Hi-C kit	Arima Hi-C Kit
Arima Hi-C Kit	Arima Hi-C Kit
ATAC-Seq Kit	ATAC-Seq Kit
AVENIO ctDNA Expanded Kit	AVENIO ctDNA Expanded Kit
Axiom 2.0 Reagent kit	Axiom 2.0 Reagent Kit
Axiom 2.0 Reagent Kit	Axiom 2.0 Reagent Kit
AXIOM 2.0 Reagent Kit	Axiom 2.0 Reagent Kit
BD Rhapsody Targeted mRNA and AbSeq Kit	BD Rhapsody Targeted mRNA and AbSeq Kit
BD Rhapsody Targeted mRNA Kit	BD Rhapsody Targeted mRNA Kit
BD Rhapsody Targeted mRNA kits	BD Rhapsody Targeted mRNA Kit
BD Rhapsody WTA Amplification Kit	BD Rhapsody WTA Amplification Kit
BD Rhapsody WTA Reagent Kit	BD Rhapsody WTA Reagent Kit
BD RhapsodyTM Targeted mRNA and AbSeq Reagent Kit	BD Rhapsody Targeted mRNA and AbSeq Kit
BGI	__DELETE__
BGI exome sequencing service	__DELETE__
BGI library construction	__DELETE__
Big Dye Terminator FS ready-reaction kit	BigDye Terminator Kit
BigDye Terminator Kit	BigDye Terminator Kit
BigDye Terminator v3.1 Cycle Sequencing kit	BigDye Terminator v3.1 Cycle Sequencing Kit
BigDye Terminator v3.1 Cycle Sequencing Kit	BigDye Terminator v3.1 Cycle Sequencing Kit
BigDye XTerminator Purification Kit	BigDye XTerminator Purification Kit
BioLegend TotalSeq-A, -B	BioLegend TotalSeq-A, -B
BioLegend TotalSeq-A/B	BioLegend TotalSeq-A/B
BioLegend TotalSeq-B	BioLegend TotalSeq-B
BioLegend TotalSeq-C	BioLegend TotalSeq-C
BioLegend, TotalSeq-A, -B	BioLegend TotalSeq-A/B
BioLegend, TotalSeq-C	BioLegend TotalSeq-C
c... 	__DELETE__
CAGE assay	CAGE
CAGE kit	CAGE Kit
CAGE Kit	CAGE Kit
CAGE Preparation Kit	CAGE Kit
Cas9 Sequencing Kit	Cas9 Sequencing Kit
Cas9 Sequencing Kit(SQK-CS9109)	Cas9 Sequencing Kit
cDNA-PCR Sequencing Kit	cDNA-PCR Sequencing Kit
cDNA-PCR Sequencing Kit (SQK-PCS111)	cDNA-PCR Sequencing Kit
CellPlex (Multiplexing Kit)	CellPlex (Multiplexing Kit)
CellRanger	__DELETE__
CHIP-IT High Sensitivity Kit	CHIP-IT High Sensitivity Kit
CHIP-IT High Sensitivity Kit (Active Motif)	CHIP-IT High Sensitivity Kit (Active Motif)
CHIP-IT PBMC Kit	CHIP-IT PBMC Kit
CHIP-IT PBMC Kit (Active Motif)	CHIP-IT PBMC Kit (Active Motif)
Chromium	Chromium Platform
Chromium Fixed RNA Profiling	Chromium Fixed RNA Profiling Kit
Chromium GEM-X Single Cell 5' GEM/Gel Bead/Chip Kit v3	Chromium GEM-X Single Cell 5' v3
Chromium GEM-X Single Cell 5' v3	Chromium GEM-X Single Cell 5' v3
Chromium Genome Library	Chromium Genome Library Kit
Chromium Genome Library & Gel Bead Kit v2	Chromium Genome Library v2
Chromium Genome Library v2	Chromium Genome Library v2
Chromium Next GEM Automated Single Cell 3' Reagent Kits v3.1	Chromium Next GEM Single Cell 3' v3.1
Chromium Next GEM Chip G Single Cell Kit	Chromium Next GEM Chip G Single Cell Kit
Chromium Next GEM Chip J Single Cell Kit	Chromium Next GEM Chip J Single Cell Kit
Chromium Next GEM Chip K Single Cell Kit	Chromium Next GEM Chip K Single Cell Kit
Chromium Next GEM Multiome	Chromium Next GEM Multiome
Chromium Next GEM Single Cell 3'	Chromium Next GEM Single Cell 3' (unspecified version)
Chromium Next GEM Single Cell 3' GEM, Library & Gel Bead Kit v3.1	Chromium Next GEM Single Cell 3' v3.1
Chromium Next GEM Single Cell 3' Kit v3.1	Chromium Next GEM Single Cell 3' v3.1
Chromium Next GEM Single Cell 3' Reagent Kits v3.1	Chromium Next GEM Single Cell 3' v3.1
Chromium Next GEM Single Cell 3' Reagent Kits v3.1 (Dual Index)	Chromium Next GEM Single Cell 3' v3.1
Chromium Next GEM Single Cell 3' v3.1	Chromium Next GEM Single Cell 3' v3.1
Chromium Next GEM Single Cell 3' v3.1 or 5' v2	Chromium Next GEM Single Cell 3' v3.1 or 5' v2
Chromium Next GEM Single Cell 3ʹ Reagent Kits	Chromium Next GEM Single Cell 3'
Chromium Next GEM Single Cell 3ʹ v3.1	Chromium Next GEM Single Cell 3' v3.1
Chromium Next GEM Single Cell 5'	Chromium Next GEM Single Cell 5' (unspecified version)
Chromium Next GEM Single Cell 5' and 3'	Chromium Next GEM Single Cell 5' and 3'
Chromium Next GEM single cell 5' and 3' kit	Chromium Next GEM Single Cell 5' and 3'
Chromium Next GEM Single Cell 5' and 3' kit	Chromium Next GEM Single Cell 5' and 3'
Chromium Next GEM Single Cell 5' Feature Barcode	Chromium Next GEM Single Cell 5' Feature Barcode
Chromium Next GEM Single Cell 5' kit	Chromium Next GEM Single Cell 5'
Chromium Next GEM Single Cell 5' Kit	Chromium Next GEM Single Cell 5'
Chromium Next GEM Single Cell 5' Kit v2	Chromium Next GEM Single Cell 5' v2
Chromium Next GEM Single Cell 5' Kit with Feature Barcode Technology	Chromium Next GEM Single Cell 5' Feature Barcode
Chromium Next GEM Single Cell 5' Kit with Feature Barcode technology for cell surface protein	Chromium Next GEM Single Cell 5' Feature Barcode
Chromium Next GEM Single Cell 5' Library & Gel Bead Kit v1.1	Chromium Next GEM Single Cell 5' v1.1
Chromium Next GEM Single Cell 5' Reagent Kit v2 Dual Index	Chromium Next GEM Single Cell 5' v2
Chromium Next GEM Single Cell 5' Reagent Kits v2	Chromium Next GEM Single Cell 5' v2
Chromium Next GEM Single Cell 5' Reagent Kits v2(Dual Index)	Chromium Next GEM Single Cell 5' v2
Chromium Next GEM Single Cell 5' v1.1	Chromium Next GEM Single Cell 5' v1.1
Chromium Next GEM Single Cell 5' v2	Chromium Next GEM Single Cell 5' v2
Chromium Next GEM Single Cell 5′ and 3′ kit	Chromium Next GEM Single Cell 5′ and 3′ kit
Chromium Next GEM Single Cell 5′ kit	Chromium Next GEM Single Cell 5'
Chromium Next GEM Single Cell 5′ Kit	Chromium Next GEM Single Cell 5'
Chromium Next GEM Single Cell 5′ Library & Gel Bead Kit v1.1	Chromium Next GEM Single Cell 5' v1.1
Chromium Next GEM Single Cell 5′ Library and Gel Bead Kit v2	Chromium Next GEM Single Cell 5′ Library and Gel Bead Kit v2
Chromium Next GEM Single Cell 5′kit	Chromium Next GEM Single Cell 5'
Chromium Next GEM Single Cell 5ʹ Library and Gel Bead Kit v2	Chromium Next GEM Single Cell 5' v2
Chromium Next GEM Single Cell ATAC	Chromium Next GEM Single Cell ATAC
Chromium Next GEM Single Cell ATAC Library Construction Kit	Chromium Next GEM Single Cell ATAC Library Construction Kit
Chromium Next GEM Single Cell ATAC Reagent Kits	Chromium Next GEM Single Cell ATAC
Chromium Next GEM Single Cell ATAC v1.1	Chromium Next GEM Single Cell ATAC v1.1
Chromium Next GEM Single Cell Multiome ATAC + Gene Expression	Chromium Next GEM Single Cell Multiome ATAC + GEX
Chromium Next GEM Single Cell Multiome ATAC + Gene Expression (10x Genomics)	Chromium Next GEM Single Cell Multiome ATAC + Gene Expression
Chromium Next GEM Single Cell Multiome ATAC + Gene Expression Reagent Bundle	Chromium Next GEM Single Cell Multiome ATAC + Gene Expression
Chromium Next GEM Single Cell Multiome ATAC + Gene Expression Reagent Kits	Chromium Next GEM Single Cell Multiome ATAC + Gene Expression
Chromium Next GEM Single Cell Multiome ATAC/GEM/Gel Bead Kit A	Chromium Next GEM Single Cell Multiome ATAC + Gene Expression
Chromium Next GEM Single Cell V(D)J Reagent Kits	Chromium Next GEM Single Cell VDJ
Chromium Next GEM Single Cell V(D)J Reagent Kits v1.1	Chromium Next GEM Single Cell VDJ v1.1
Chromium Next GEM Single Cell V(D)J Reagent Kits v1.1 (10x Genomics)	Chromium Next GEM Single Cell VDJ v1.1
Chromium Next GEM Single Cell VDJ	Chromium Next GEM Single Cell V(D)J
Chromium Next GEM Single Cell VDJ v1.1	Chromium Next GEM Single Cell V(D)J v1.1
Chromium NextGEM Single Cell ATAC Reagent Kits v1.1	Chromium Next GEM Single Cell ATAC v1.1
Chromium Single Cell 3'	Chromium Single Cell 3' (unspecified version)
Chromium single cell 3' kit (10XGenomics)	Chromium Single Cell 3'
Chromium single cell 3' kit version 3 (10x Genomics)	Chromium Single Cell 3' v3
Chromium Single Cell 3' Reagent Kit V3.1	Chromium Single Cell 3' v3.1
Chromium Single Cell 3' Reagent Kits v2	Chromium Single Cell 3' v2
Chromium Single Cell 3' Reagent Kits v3	Chromium Single Cell 3' v3
Chromium Single Cell 3' v1	Chromium Single Cell 3' v1
Chromium Single Cell 3' v1 Reagent kit	Chromium Single Cell 3' v1
Chromium Single Cell 3' v2	Chromium Single Cell 3' v2
Chromium Single Cell 3' v3	Chromium Single Cell 3' v3
Chromium Single Cell 3' v3.1	Chromium Single Cell 3' v3.1
Chromium Single Cell 3′ v3 (Gel Bead Kit v3)	Chromium Single Cell 3′ v3 (Gel Bead Kit v3)
Chromium Single Cell 3ʹ v2 Reagent Kits	Chromium Single Cell 3' v2
Chromium Single Cell 5'	Chromium Single Cell 5' (unspecified version)
Chromium Single Cell 5' Library Kit	Chromium Single Cell 5' Library Kit
Chromium Single Cell 5' Reagent Kits v1	Chromium Single Cell 5' v1
Chromium Single Cell 5' Reagent Kits v2	Chromium Single Cell 5' v2
Chromium Single Cell 5' v1	Chromium Single Cell 5' v1
Chromium Single Cell 5' v2	Chromium Single Cell 5' v2
Chromium Single Cell 5′ Reagent Kits	Chromium Single Cell 5'
Chromium Single Cell 5ʹ Library Kit	Chromium Single Cell 5' Library Kit
Chromium Single Cell DNA	Chromium Single Cell DNA Kit
Chromium Single Cell DNA Reagent Kits	Chromium Single Cell DNA
Chromium Single Cell Human BCR Amplification Kit	Chromium Single Cell Human BCR Amplification Kit
Chromium Single Cell Human TCR Amplification Kit	Chromium Single Cell Human TCR Amplification Kit
Chromium Single Cell V(D)J	Chromium Single Cell VDJ
Chromium Single Cell V(D)J Enrichment Kits	Chromium Single Cell VDJ Enrichment Kit
Chromium Single Cell VDJ	Chromium Single Cell V(D)J
Chromium Single Cell VDJ Enrichment Kit	Chromium Single Cell VDJ Enrichment Kit
Chromium Single-Cell DNA Reagent Kit	Chromium Single Cell DNA
ClearSeq Comprehensive Cancer Kit	ClearSeq Comprehensive Cancer Kit
ClearSeq SS Comprehensive Cancer kits	ClearSeq Comprehensive Cancer Kit
cnc-0.1	__DELETE__
cnv-0x0	__DELETE__
CODEX Staining Kit	CODEX Staining Kit
custom	__DELETE__
Custom	Custom
custom designed SureSelect XT2 Kit	SureSelect XT2 Custom Kit
custom MultiplexPCR	custom MultiplexPCR
CUT&RUN Library Prep Kit	CUT&RUN Library Prep Kit
Cytoscan HD Kit	Cytoscan HD Kit
description	__DELETE__
DMET Plus Premier Pack Kit	DMET Plus Premier Pack Kit
DMET Plus Premier pack kits	DMET Plus Premier Pack Kit
DNA	__DELETE__
DNA Library Construction Kit	DNA Library Construction Kit
DNA methylation	__DELETE__
DNA template prep kit 2.0	DNA Template Prep Kit 2.0
DNA Template Prep Kit 2.0	DNA Template Prep Kit 2.0
DNeasy PowerSoil Pro Kit	DNeasy PowerSoil Pro Kit
Dovetail Micro-C kit	Dovetail Micro-C Kit
Dovetail Micro-C Kit	Dovetail Micro-C Kit
Drop-Seq	Drop-seq
Drop-Seq Laboratory Protocol, version 3.1	Drop-seq
EnVision FLEX Kit	EnVision FLEX Kit
EnVision FLEX Kit, High pH (Agilent, ＃K8002)	EnVision FLEX Kit
EpiTect Fast Bisulfite Conversion Kit	EpiTect Fast Bisulfite Conversion Kit
EpiTect Fast Bisulﬁte Conversion Kit	EpiTect Fast Bisulfite Conversion Kit
EpiTect Fast Bisulfite Conversion kits	EpiTect Fast Bisulfite Conversion Kit
exome	__DELETE__
Exome2.0 plus Comprehensive Exome Spike-in	Exome2.0 plus Comprehensive Exome Spike-in
EZ DNA Methylation Kit	EZ DNA Methylation Kit
EZ DNA Methylation-Gold	EZ DNA Methylation-Gold Kit
EZ DNA Methylation-Gold Kit	EZ DNA Methylation-Gold Kit
EZ DNA Methylation™ Kit	EZ DNA Methylation™ Kit
EZ DNAMethylation-Gold Kit ver.2.1.3	EZ DNA Methylation-Gold Kit
Fast-ATAC-seq	Fast-ATAC-seq
Fast-ATAC-seq protocol	Fast-ATAC-seq
FinnGen1 ThermoFisher Array	FinnGen1 ThermoFisher Array
Fluidigm C1	Fluidigm C1
FuPa Reagent (Thermo Fisher Scientific)	FuPa Reagent (Thermo Fisher Scientific)
GeneChip 3' IVT Express Kit	GeneChip 3' IVT Express Kit
GeneWiz	__DELETE__
Genome-Wide Human SNP Array 6.0 Kit	Genome-Wide Human SNP Array 6.0 Kit
HaloPlex HS Custom Kit	HaloPlex HS Custom Kit
HaloPlex Target Enrichment	HaloPlex Target Enrichment
HaloPlex Target Enrichment System	HaloPlex Target Enrichment
HiSeq SBS Kit v4	HiSeq SBS Kit v4
hoge	__DELETE__
Human Agilent V6	SureSelect Human All Exon V6
Human Myeloid Neoplasms QIAseq Targeted DNA Panel	Human Myeloid Neoplasms QIAseq Targeted DNA Panel
Human610-Quad BeadChip	Human610-Quad BeadChip Kit
Human610-Quad Beadchip kit	Human610-Quad BeadChip Kit
Human610-Quad BeadChip Kit	Human610-Quad BeadChip Kit
Human610-Quad kit v1	Human610-Quad BeadChip Kit
HumanCoreExome BeadChip Kit	HumanCoreExome BeadChip Kit
HumanCoreExome-12v1 BeadChip Kit	HumanCoreExome-12v1 BeadChip Kit
HumanExome	HumanExome BeadChip Kit
HumanExome BeadChip	HumanExome BeadChip Kit
HumanExome BeadChip kit	HumanExome BeadChip Kit
HumanExome BeadChip Kit	HumanExome BeadChip Kit
HumanExome-12 kit	HumanExome BeadChip Kit
HumanExome-12 kit v1	HumanExome BeadChip Kit
HumanExome-12v1 BeadChip Kit	HumanExome BeadChip Kit
HumanHap550 BeadChip Kit	HumanHap550 BeadChip Kit
HumanHap550 kit	HumanHap550 BeadChip Kit
HumanHap550v3 Genotyping BeadChip	HumanHap550 BeadChip Kit
HumanOmni2.5-4v1 BeadChip Kit	HumanOmni2.5-4v1 BeadChip Kit
HumanOmni2.5-8 BeadChip Kit	HumanOmni2.5-8 BeadChip Kit
HumanOmni2.5-8 v1.0 BeadChip Kit	HumanOmni2.5-8 BeadChip Kit
HumanOmni2.5-8v1 BeadChip Kit	HumanOmni2.5-8 BeadChip Kit
HumanOmni2.5S-8v1 BeadChip Kit	HumanOmni2.5-8 BeadChip Kit
HumanOmni5 BeadChip Kit	HumanOmni5 BeadChip Kit
HumanOmniExpress	HumanOmniExpress BeadChip Kit
HumanOmniExpress BeadChip	HumanOmniExpress BeadChip Kit
HumanOmniExpress Beadchip kit	HumanOmniExpress BeadChip Kit
HumanOmniExpress BeadChip kit	HumanOmniExpress BeadChip Kit
HumanOmniExpress BeadChip Kit	HumanOmniExpress BeadChip Kit
HumanOmniExpress-12	HumanOmniExpress BeadChip Kit
HumanOmniExpress-12 BeadChip	HumanOmniExpress BeadChip Kit
HumanOmniExpress、HumanExome、OmniExpressExome BeadChip kit	__DELETE__
humanomniexpressbeadchip	HumanOmniExpress BeadChip Kit
humanOmniExpressExome	HumanOmniExpressExome BeadChip Kit
HumanOmniExpressExome	HumanOmniExpressExome BeadChip Kit
HumanOmniExpressExome BeadChip	HumanOmniExpressExome BeadChip Kit
HumanOmniExpressExome BeadChip Kit	HumanOmniExpressExome BeadChip Kit
HumanOmniExpressExome-8	HumanOmniExpressExome BeadChip Kit
IDT for Illumina RNA UD Indexes Set A-B Ligation	IDT for Illumina RNA UD Indexes Set A-B Ligation
IDT for Illumina TruSeq DNA UD Indexes	IDT for Illumina TruSeq DNA UD Indexes
IDT for Illumina TruSeq UD Indexes	IDT for Illumina TruSeq UD Indexes
IDT Lotus DNA Library Prep Kit	IDT Lotus DNA Library Prep Kit
Illumina	__DELETE__
Illumina [HumanOmniExpress、HumanExome、OmniExpressExome BeadChip]	__DELETE__
Illumina [Nextera Rapid Capture Exome(v1.2)]	Illumina [Nextera Rapid Capture Exome(v1.2)]
Illumina 16S Metagenomic Sequencing Library Preparation protocol	16S Metagenomic Sequencing Library Prep
Illumina DNA PCR-Free Prep	Illumina DNA PCR-Free Prep
Illumina DNA Prep with Enrichment	Illumina DNA Prep with Enrichment
Illumina Human610-Quad Beadchip	Human610-Quad BeadChip Kit
Illumina Human610-Quad Beadchip kit	Human610-Quad BeadChip Kit
Illumina Human610-Quad Beadchip Kit	Human610-Quad BeadChip Kit
Illumina Human610-Quad BeadChip Kit	Human610-Quad BeadChip Kit
Illumina HumanCoreExome BeadChip kit	HumanCoreExome BeadChip Kit
Illumina HumanCoreExome BeadChip Kit	HumanCoreExome BeadChip Kit
Illumina HumanExome	HumanExome BeadChip Kit
Illumina HumanMethylation450 BeadChip kit	Infinium HumanMethylation450 BeadChip Kit
Illumina HumanOmni2.5-Quad BeadChip Kit	Illumina HumanOmni2.5-Quad BeadChip Kit
Illumina HumanOmniExpress	HumanOmniExpress BeadChip Kit
Illumina HumanOmniExpress BeadChip kit	HumanOmniExpress BeadChip Kit
Illumina HumanOmniExpressExome	HumanOmniExpressExome BeadChip Kit
Illumina Infinium OmniExpress	Infinium OmniExpress
Illumina Infinium OmniExpressExome BeadChip	Infinium OmniExpressExome BeadChip Kit
Illumina Infinium OmniExpressExome BeadChips kit	Infinium OmniExpressExome BeadChip Kit
Illumina Infinium OmniExpressExome-8 Beadchip Kit	Infinium OmniExpressExome-8 BeadChip Kit
Illumina Nextera Rapid Capture Exome(v1.2)	Nextera Rapid Capture Exome
Illumina OmniExpressExome BeadChip	OmniExpressExome BeadChip Kit
Illumina OmniExpressExome Beadchip kit	OmniExpressExome BeadChip Kit
Illumina Stranded mRNA Prep	Illumina Stranded mRNA Prep
Illumina Stranded Total RNA Prep with Ribo-Zero Plus	Illumina Stranded Total RNA Prep with Ribo-Zero Plus
Illumina Stranded Total RNA Prep, Ligation with Ribo-Zero Plus	Illumina Stranded Total RNA Prep, Ligation with Ribo-Zero Plus
Illumina SureSelect V4-post	SureSelect Human All Exon V4
Illumina Tagment DNA TDE1 Enzyme and Buffer Kits	Tagment DNA TDE1 Kit
Illumina Tru Tru	Illumina Tru Tru
Illumina TruGenome	Illumina TruGenome
Illumina TruSeq	Illumina TruSeq
Illumina TruSeq ChIP Sample Prep Kit	TruSeq ChIP Sample Prep Kit
Illumina Truseq Custom Amplicon	TruSeq Custom Amplicon
Illumina TruSeq DNA Methylation Kit	Illumina TruSeq DNA Methylation Kit
Illumina TruSeq DNA Nano Library Prep Kit	Illumina TruSeq DNA Nano Library Prep Kit
Illumina TruSeq DNA PCR-Free Library Prep Kit	Illumina TruSeq DNA PCR-Free Library Prep Kit
Illumina TruSeq DNA sample preparation kit	TruSeq DNA Sample Prep Kit
Illumina TruSeq Nano DNA Library Prep Kit	Illumina TruSeq Nano DNA Library Prep Kit
Illumina TruSeq RNA Library Prep Kit	TruSeq RNA Library Prep Kit
Illumina TruSeq Stranded mRNA Library Prep Kit	Illumina TruSeq Stranded mRNA Library Prep Kit
Illumina TruSight Exome Kit	TruSight Exome Kit
illuminahumanomni5beadchip	HumanOmni5 BeadChip Kit
Immunochip	Immunochip
Infinium Asian Screening Array	Infinium Asian Screening Array Kit
Infinium Asian Screening Array BeadChip kit	Infinium Asian Screening Array Kit
Infinium Asian Screening Array BeadChip Kit	Infinium Asian Screening Array Kit
Infinium Asian Screening Array Kit	Infinium Asian Screening Array Kit
Infinium Asian Screening Array-24 v1.0 BeadChip Kit	Infinium Asian Screening Array Kit
Infinium Human Methylation 450K BeadChip kit	Infinium HumanMethylation450 BeadChip Kit
Infinium Human MethylationEPIC BeadChip Kit	Infinium MethylationEPIC BeadChip Kit
Infinium HumanMethylation450 BeadChip	Infinium HumanMethylation450 BeadChip Kit
Infinium HumanMethylation450 BeadChip Kit	Infinium HumanMethylation450 BeadChip Kit
Infinium HumanOmni2.5-8 kit	Infinium HumanOmni2.5-8 Kit
Infinium HumanOmni2.5-8 Kit	Infinium HumanOmni2.5-8 Kit
Infinium HumanOmniExpressExome-8 kit	Infinium OmniExpressExome-8 Kit
Infinium HumanOmniExpressExome-8 kit v1.2	Infinium OmniExpressExome-8 Kit
Infinium HumanOmniExpressExome-8 kit v1.3	Infinium OmniExpressExome-8 Kit
Infinium HumanOmniExpressExome-8 kit v1.4	Infinium OmniExpressExome-8 Kit
Infinium HumanOmniExpressExome-8 kit v1.6	Infinium OmniExpressExome-8 Kit
Infinium MethylationEPIC	Infinium MethylationEPIC BeadChip Kit
Infinium MethylationEPIC BeadChip	Infinium MethylationEPIC BeadChip Kit
Infinium MethylationEPIC BeadChip Kit	Infinium MethylationEPIC BeadChip Kit
Infinium MethylationEPIC kit	Infinium MethylationEPIC BeadChip Kit
Infinium MethylationEPIC Kit, v1.0	Infinium MethylationEPIC BeadChip Kit
Infinium Omni2.5-8 v1.4 BeadChip Kit	Infinium Omni2.5-8 v1.4 BeadChip Kit
Infinium OmniExpress	Infinium OmniExpress
Infinium OmniExpress-24 kit	Infinium OmniExpress-24 Kit
Infinium OmniExpress-24 Kit	Infinium OmniExpress-24 Kit
Infinium OmniExpressExome BeadChip Kit	Infinium OmniExpressExome BeadChip Kit
Infinium OmniExpressExome Kit	Infinium OmniExpressExome Kit
Infinium OmniExpressExome v.1.0	Infinium OmniExpressExome Kit
Infinium OmniExpressExome v.1.2	Infinium OmniExpressExome Kit
Infinium OmniExpressExome-8 BeadChip Kit	Infinium OmniExpressExome-8 BeadChip Kit
Infinium OmniExpressExome-8 Kit	Infinium OmniExpressExome-8 Kit
Infinium OmniExpressExome-8 v1.4 BeadChip Kit	Infinium OmniExpressExome-8 Kit
Infinium OncoArray-500K v1.0 BeadChip Kit	Infinium OncoArray-500K v1.0 BeadChip Kit
Infinium® Human Methylation 450K BeadChip kit	Infinium® Human Methylation 450K BeadChip kit
Ion AmpliSeq Custom kit	Ion AmpliSeq Custom Kit
Ion AmpliSeq Custom Kit	Ion AmpliSeq Custom Kit
Ion AmpliSeq Custom Panel	Ion AmpliSeq Custom Panel
Ion Ampliseq Designer	Ion AmpliSeq Designer
Ion AmpliSeq Designer	Ion AmpliSeq Designer
Ion AmpliSeq Exome RDY kit	Ion AmpliSeq Exome RDY Kit
Ion AmpliSeq Exome RDY Kit	Ion AmpliSeq Exome RDY Kit
Ion AmpliSeq Kit for Chef DL8	Ion AmpliSeq Kit for Chef DL8
Ion AmpliSeq Library Kit	Ion AmpliSeq Library Kit
Ion AmpliSeq Library Kit 2.0	Ion AmpliSeq Library Kit 2.0
Ion AmpliSeq Library Kit for Chef DL8	Ion AmpliSeq Library Kit for Chef DL8
Ion Ampliseq Library Kit Plus	Ion AmpliSeq Library Kit Plus
Ion AmpliSeq Library Kit Plus	Ion AmpliSeq Library Kit Plus
Ion AmpliSeq Library Kit ver 2.0	Ion AmpliSeq Library Kit 2.0
Ion AmpliSeq Plus Kit	Ion AmpliSeq Plus Kit
Ion AmpliSeq Transcriptome Human Gene Expression Kit	Ion AmpliSeq Transcriptome Human Gene Expression Kit
Ion AmpliSeq™ Library Kit 2.0	Ion AmpliSeq™ Library Kit 2.0
Ion Fragment Library Kit	Ion Fragment Library Kit
Ion Fragment plus library Kit	Ion Fragment Library Kit
Ion PI Sequencing 200 Kit v3	Ion PI Sequencing 200 Kit v3
Ion PI Template OT2 200 Kit v3	Ion PI Template OT2 200 Kit v3
Ion Total RNA-seq Kit v2	Ion Total RNA-Seq Kit v2
Ion Total RNA-Seq Kit v2	Ion Total RNA-Seq Kit v2
Ion Total RNA-seq Kit v2 (Thermo Fisher Scientific)	Ion Total RNA-seq Kit v2 (Thermo Fisher Scientific)
Ion Xpress Barcode Adapters	Ion Xpress Barcode Adapters
IonAmpliSeq Plus Kit	Ion AmpliSeq Plus Kit
KAPA HiFi DNA Polymerase	KAPA HiFi DNA Polymerase
KAPA HiFi HotStart Ready Mix PCR Kit	KAPA HiFi HotStart Ready Mix PCR Kit
KAPA Hyper Plus	KAPA HyperPlus Kit
KAPA Hyper Prep kit	KAPA Hyper Prep Kit
KAPA Hyper Prep Kit	KAPA Hyper Prep Kit
KAPA Hyper Prep kit xGen@ Acute Myeloid Leukemia Cancer Panel	KAPA Hyper Prep kit xGen@ Acute Myeloid Leukemia Cancer Panel
KAPA Hyper Prep Plus	KAPA HyperPlus Kit
KAPA Hyper Preparation kit	KAPA Hyper Prep Kit
KAPA HyperChoice Probes	KAPA HyperChoice Probes
KAPA HyperPlus Kit	KAPA HyperPlus Kit
KAPA HyperPlus Library Preparation Kit (Roche)	KAPA HyperPlus Library Preparation Kit (Roche)
KAPA HyperPlus Library Preparation Kit (Roche) – for ATAC‑seq	KAPA HyperPlus Library Preparation Kit (Roche) – for ATAC‑seq
KAPA HyperPlus Library Preparation Kit (Roche) – for RNA‑seq	KAPA HyperPlus Library Preparation Kit (Roche) – for RNA‑seq
KAPA Library Preparation Kit	KAPA Library Preparation Kit
KAPA RNA HyperPrep Kit	KAPA RNA HyperPrep Kit
KAPA RNA HyperPrep Kit (Roche)	KAPA RNA HyperPrep Kit (Roche)
KAPA RNA HyperPrep Kit with RiboErase	KAPA RNA HyperPrep Kit with RiboErase
Library Construction Kit C	Library Construction Kit C
Library Preparation Enzymatic Fragmentation Kit 2.0	Library Preparation Enzymatic Fragmentation Kit 2.0
life	__DELETE__
Life.	__DELETE__
ligation sequencing kit (SQK-LSK109)	Ligation Sequencing Kit SQK-LSK109
Ligation Sequencing Kit (SQK-LSK109)	Ligation Sequencing Kit SQK-LSK109
Ligation Sequencing Kit (SQK-LSK110)	Ligation Sequencing Kit SQK-LSK110
Ligation Sequencing Kit SQK-LSK109	Ligation Sequencing Kit SQK-LSK109
Ligation Sequencing Kit SQK-LSK110	Ligation Sequencing Kit SQK-LSK110
Ligation Sequencing Kit SQK-LSK114	Ligation Sequencing Kit SQK-LSK114
Ligation Sequencing Kit V14 (SQK-LSK114)	Ligation Sequencing Kit SQK-LSK114
ligation sequencing kit(SQK-LSK109)	ligation sequencing kit(SQK-LSK109)
Lotus DNA Library Prep Kit	Lotus DNA Library Prep Kit
Low Input Quick Amp Labeling Kit	Low Input Quick Amp Labeling Kit
Low Input Quick Amp Labeling Kit One color	Low Input Quick Amp Labeling Kit
Low Quantity single strand CAGE protocol	Low Quantity ssCage
Low Quantity ssCage	Low Quantity ssCage
lung	__DELETE__
lung cancer	__DELETE__
M2	__DELETE__
MagAttract HMW DNA Kit	MagAttract HMW DNA Kit
MAS-Seq for 10x Single Cell 3'	MAS-Seq for 10x Single Cell 3'
MAS-Seq for 10x Single Cell 3' kit	MAS-Seq for 10x Single Cell 3'
MBC adapter kit for Illumina	MBC adapter kit for Illumina
MERSCOPE 140 gene panel	MERSCOPE 140 Gene Panel
MERSCOPE 140 Gene Panel	MERSCOPE 140 Gene Panel
Methyl-seq	__DELETE__
Methyl-Seq Set A Indexing Kit	Methyl-Seq Set A Indexing Kit
Methyl-Seq Set A Indexing Kit (Swift Biosciences)	Methyl-Seq Set A Indexing Kit
Methylome	__DELETE__
MGIEasy DNA library prep kit	MGIEasy DNA Library Prep Kit
MGIEasy DNA Library Prep Kit	MGIEasy DNA Library Prep Kit
MGIEasy PCR-Free DNA Library Prep Set	MGIEasy PCR-Free DNA Library Prep Set
MGIEasy RNA Directional Library Prep Set	MGIEasy RNA Directional Library Prep Set
MGIEasy Universal Library Conversion Kit	MGIEasy Universal Library Conversion Kit
Microarray	__DELETE__
mRNA-Seq Sample Prep Kit	mRNA-Seq Sample Prep Kit
MultiplexPCR	__DELETE__
Nanopore Sequencing Kit	Nanopore Sequencing Kit
nAnT-iCAGE	nAnT-iCAGE
nAnT-iCAGE protocol	nAnT-iCAGE
nAnT-iCAGE v2.1	nAnT-iCAGE
nAnT-iCAGE プロトコル	nAnT-iCAGE
NCC Oncopanel kit	NCC Oncopanel Kit
NCC Oncopanel Kit	NCC Oncopanel Kit
nCounter Human Immunology V2 Panel CodeSet	nCounter Human Immunology V2 Panel CodeSet
NEBNext	NEBNext
NEBNext Enzymatic Methyl-seq Kit	NEBNext Enzymatic Methyl-seq Kit
NEBNext Multiplex Oligos for Illumina	NEBNext Multiplex Oligos for Illumina
NEBNext Multiplex Oligos for Illumina (96 Unique Dual Index Primer Pairs)	NEBNext Multiplex Oligos for Illumina (96 Unique Dual Index Primer Pairs)
NEBNext Poly(A) mRNA Magnetic Isolation Module	NEBNext Poly(A) mRNA Magnetic Isolation Module
NEBNext rRNA Depletion Kit	NEBNext rRNA Depletion Kit
NEBNext Small RNA Library Prep Set for Illumina	NEBNext Small RNA Library Prep Set for Illumina
NEBNext Small RNA Library Prep Set for Illumina (New England Biolabs)	NEBNext Small RNA Library Prep Set for Illumina
NEBNext Ultra Directional RNA Library Prep Kit	NEBNext Ultra Directional RNA Library Prep Kit for Illumina
NEBNext Ultra Directional RNA Library Prep Kit for Illumina	NEBNext Ultra Directional RNA Library Prep Kit for Illumina
NEBNext Ultra Directional RNA Library Prep Kit for Illumina(New England BioLabs)	NEBNext Ultra Directional RNA Library Prep Kit for Illumina(New England BioLabs)
NEBNext Ultra DNA Library Prep Kit	NEBNext Ultra DNA Library Prep Kit for Illumina
NEBNext Ultra DNA library prep kit for Illumina	NEBNext Ultra DNA Library Prep Kit for Illumina
NEBNext Ultra DNA Library Prep Kit for Illumina	NEBNext Ultra DNA Library Prep Kit for Illumina
NEBNext Ultra DNA Library Prep Kit SureSelect Human All Exon Kit v5	NEBNext Ultra DNA Library Prep Kit for Illumina
NEBNext Ultra II Directional RNA Library Prep Kit	NEBNext Ultra II Directional RNA Library Prep Kit for Illumina
NEBNext Ultra II Directional RNA Library Prep Kit (New England Biolabs)	NEBNext Ultra II Directional RNA Library Prep Kit (New England Biolabs)
NEBNext Ultra II Directional RNA Library Prep Kit for Illumina	NEBNext Ultra II Directional RNA Library Prep Kit for Illumina
NEBNext Ultra II DNA Library Prep Kit	NEBNext Ultra II DNA Library Prep Kit for Illumina
NEBNext Ultra II DNA Library Prep Kit for Illumina	NEBNext Ultra II DNA Library Prep Kit for Illumina
NEBNext Ultra II DNA PCR-free Library Prep Kit for Illumina	NEBNext Ultra II DNA PCR-free Library Prep Kit for Illumina
NEBNext Ultra II FS DNA Module	NEBNext Ultra II FS DNA Module
NEBNext Ultra II RNA Library Prep Kit	NEBNext Ultra II RNA Library Prep Kit for Illumina
NEBNext Ultra II RNA Library Prep Kit for Illumina	NEBNext Ultra II RNA Library Prep Kit for Illumina
NEBNext Ultra RNA Library Prep Kit for Illumina	NEBNext Ultra RNA Library Prep Kit for Illumina
NEBNext Ultra RNA Library Prep Kit for Illumina TruSeq RNA Sample Preparation Kit v2	NEBNext Ultra RNA Library Prep Kit for Illumina
NEBNext Ultra RNA library prep kit for the Illumina	NEBNext Ultra RNA Library Prep Kit for Illumina
NEBNext UltraDirectional RNA Library Prep Kit	NEBNext Ultra Directional RNA Library Prep Kit for Illumina
NEBNext UltraII Directional RNA Library Prep Kit	NEBNext Ultra II Directional RNA Library Prep Kit for Illumina
NEBNext UltraII DNA Library Prep Kit for Illumina	NEBNext Ultra II DNA Library Prep Kit for Illumina
NEBNext UltraTM RNA Library Prep Kit for Illumina	NEBNext Ultra RNA Library Prep Kit for Illumina
NEBNext® Poly(A) mRNA Magnetic Isolation Module	NEBNext® Poly(A) mRNA Magnetic Isolation Module
NEBNext® Ultra II Directional RNA Library Prep Kit	NEBNext® Ultra II Directional RNA Library Prep Kit
NEBNext® Ultra™ Directional RNA Library Prep Kit for Illumina	NEBNext® Ultra™ Directional RNA Library Prep Kit for Illumina
NEXT Ultra DNA Library Prep kit for Illumina	NEBNext Ultra DNA Library Prep Kit for Illumina
Nextera	Nextera DNA Library Prep Kit
Nextera DNA Flex Library Prep	Nextera DNA Flex Library Prep
Nextera DNA Library Prep Kit	Nextera DNA Library Prep Kit
Nextera Mate Pair Sample Preparation Kit	Nextera Mate Pair Sample Preparation Kit
Nextera Rapid Capture Exome	Nextera Rapid Capture Exome
Nextera Rapid Capture Exome kit	Nextera Rapid Capture Exome Kit
Nextera Rapid Capture Exome Kit	Nextera Rapid Capture Exome Kit
Nextera Rapid Capture Exome Kit (Illumina) (6 samples)	Nextera Rapid Capture Exome Kit (Illumina) (6 samples)
Nextera Rapid Capture Exome Kit (Illumina) (96 samples)	Nextera Rapid Capture Exome Kit (Illumina) (96 samples)
Nextera Rapid Capture kit	Nextera Rapid Capture Kit
Nextera Rapid Capture Kit	Nextera Rapid Capture Kit
Nextera XT	Nextera XT DNA Library Prep Kit
Nextera XT DNA Library Prep Kit	Nextera XT DNA Library Prep Kit
Nextera XT DNA Library Preparation Kit	Nextera XT DNA Library Prep Kit
Nextera XT DNA sample preparation Kit	Nextera XT DNA Library Prep Kit
Nextera XT DNA Sample Preparation kit	Nextera XT DNA Library Prep Kit
Nextera XT DNA Sample Preparation Kit	Nextera XT DNA Library Prep Kit
Nextera XT Index Kit v2 Set A	Nextera XT Index Kit v2 Set A
Nextera XT(Illumina)	Nextera XT DNA Library Prep Kit
NEXTflex Small RNA Sequencing kit v3	NEXTflex Small RNA Sequencing Kit v3
NEXTflex Small RNA Sequencing Kit v3	NEXTflex Small RNA Sequencing Kit v3
Nimblegen SeqCap EZ Library LR	Nimblegen SeqCap EZ Library LR
Nimblegen SeqCap EZ Library SR	Nimblegen SeqCap EZ Library SR
non-small cell carcinoma	__DELETE__
Olink Explore 3072	Olink Explore 3072
Olink Target 96	Olink Target 96
Omni-ATAC	Omni-ATAC
Omni-ATAC protocol	Omni-ATAC
Omni2.5-8	HumanOmni2.5-8 BeadChip Kit
OmniExpress-12	HumanOmniExpress BeadChip Kit
OmniExpress-24	HumanOmniExpress BeadChip Kit
OmniExpressExome	HumanOmniExpressExome BeadChip Kit
OmniExpressExome BeadChip	OmniExpressExome BeadChip Kit
OmniExpressExome Beadchip kit	OmniExpressExome BeadChip Kit
OmniExpressExome BeadChip kit	OmniExpressExome BeadChip Kit
OmniExpressExome BeadChip Kit	OmniExpressExome BeadChip Kit
Ovation RRBS Methyl-Seq System 1-16	Ovation RRBS Methyl-Seq System 1-16
Ovation Ultralow System V2 kit	Ovation Ultralow System V2 Kit
Ovation Ultralow System V2 Kit	Ovation Ultralow System V2 Kit
Ovation Ultralow System V2 kit (NuGEN)	Ovation Ultralow System V2 Kit
PacBio DNA Template Prep Kit	PacBio DNA Template Prep Kit
Pacific Biosciences SMRT library prep kit	SMRT Library Prep Kit
paired-end	__DELETE__
Paired-End DNA Sample Prep Kit	Paired-End DNA Sample Prep Kit
PBAT	PBAT
PBAT (post‑bisulfite adaptor tagging) library construction	PBAT (post‑bisulfite adaptor tagging) library construction
PCR product presequencing kit	PCR Product Presequencing Kit
PCR Product Presequencing Kit	PCR Product Presequencing Kit
PCR product presequencing kit (Amersham Biosciences)	PCR product presequencing kit (Amersham Biosciences)
peripheral blood	__DELETE__
Post-Bisulfite Adaptor-Tagging (PBAT)	PBAT
QIAseq Targeted DNA Custom Panel	QIAseq Targeted DNA Custom Panel
QIAseq Targeted DNA Panels	QIAseq Targeted DNA Panels
Quick-Amp Labeling Kit	Quick-Amp Labeling Kit
RampUP RNA amplification Kit	RampUP RNA Amplification Kit
RampUP RNA Amplification Kit	RampUP RNA Amplification Kit
RampUP RNA amplification Kit (Genisphere)	RampUP RNA amplification Kit (Genisphere)
Ribo-Zero Gold kit	Ribo-Zero Gold Kit
Ribo-Zero Gold Kit	Ribo-Zero Gold Kit
Ribo-Zero Magnetic Gold Kit	Ribo-Zero Magnetic Gold Kit
RiboZero	RiboZero
RNA-Seq	__DELETE__
Roche/NimbleGen [SeqCap EZ Human Exome Library v3.0]	Roche/NimbleGen [SeqCap EZ Human Exome Library v3.0]
Roche/NimbleGen SeqCap EZ Human Exome Library v3.0	SeqCap EZ Human Exome v3.0
ScriptSeq v2 RNA-seq Library Preparation Kit	ScriptSeq v2 RNA-seq Library Preparation Kit
ScriptSeq v2 RNA-seq Library Preparation Kit (Epicentre)	ScriptSeq v2 RNA-seq Library Preparation Kit (Epicentre)
scRNA-seq	__DELETE__
SeqCap EZ choice	SeqCap EZ Choice
SeqCap EZ Choice	SeqCap EZ Choice
SeqCap EZ HGSC VCRome2.1 design1	SeqCap EZ HGSC VCRome2.1 design1
SeqCap EZ Human Exome v3.0	SeqCap EZ Human Exome v3.0
SeqCap EZ MedExome (Roche) (13 samples)	SeqCap EZ MedExome (Roche) (13 samples)
Single Cell 3′ Library & Gel Bead Kit v2 and the A Chip Kit (10X Genomics)	Chromium Single Cell 3' v2
Single Cell Immune Profiling Solution Kit	Single Cell Immune Profiling Solution Kit
Single Index Kit T Set A	Single Index Kit T Set A
Smart Seq Stranded kit	SMART-Seq Stranded Kit
SMART-Seq HT Kit	SMART-Seq HT Kit
SMART-Seq mRNA LP	SMART-Seq mRNA LP
SMART-seq Stranded kit	SMART-Seq Stranded Kit
SMART-seq Stranded Kit	SMART-Seq Stranded Kit
SMART-Seq Stranded Kit	SMART-Seq Stranded Kit
SMART-Seq Stranded Total RNA Kit	SMART-Seq Stranded Total RNA Kit
Smart-Seq v2	SMART-Seq v2
SMART-Seq v2	SMART-Seq v2
SMART-seq v4 Ultra Low Input RNA Kit	SMART-Seq v4 Ultra Low Input RNA Kit
SMART-Seq v4 Ultra Low Input RNA Kit	SMART-Seq v4 Ultra Low Input RNA Kit
SMART-Seq v4 Ultra Low Input RNA Kit for Sequencing	SMART-Seq v4 Ultra Low Input RNA Kit
SMART-seq v4 Ultra Low Input RNA Kit SQK-LSK109	SMART-Seq v4 Ultra Low Input RNA Kit
SMART‑seq v4 Ultra Low Input RNA Kit (Clontech)	SMART‑seq v4 Ultra Low Input RNA Kit (Clontech)
SMART‑Seq v4 Ultra Low Input RNA Kit (Takara Bio)	SMART‑Seq v4 Ultra Low Input RNA Kit (Takara Bio)
SMART‑seq2 (Takara Bio)	SMART‑seq2 (Takara Bio)
SMARTer ICELL8 3' DE Reagent Kit	SMARTer ICELL8 3' DE Reagent Kit
SMARTer ICELL8 Reagent 3' DE Reagent Kit	SMARTer ICELL8 3' DE Reagent Kit
SMARTer Kit	SMARTer Kit
SMARTer smRNA-Seq Kit	SMARTer smRNA-Seq Kit for Illumina
SMARTer smRNA-Seq Kit for Illumina	SMARTer smRNA-Seq Kit for Illumina
SMARTer Stranded Total RNA-Seq Kit v2 - Pico Input Mammalian	SMARTer Stranded Total RNA-Seq Kit v2 - Pico Input Mammalian
SMARTer Stranded Total RNA‑Seq Kit (Takara Bio)	SMARTer Stranded Total RNA‑Seq Kit (Takara Bio)
SMARTer ThruPLEX DNA-seq Kit	SMARTer ThruPLEX DNA-seq Kit
SMARTer ThruPLEX tag-seq Kit	SMARTer ThruPLEX tag-seq Kit
SMARTer Ultra Low Input RNA Kit for Sequencing	SMARTer Ultra Low Input RNA Kit for Sequencing
SMRT Library Prep Kit	SMRT Library Prep Kit
SMRTbell Express Template Prep Kit 3.0	SMRTbell Express Template Prep Kit 3.0
SMRTbell Template Prep Kit 1.0	SMRTbell Template Prep Kit 1.0
SMRTbell Template Prep Kit 2.0	SMRTbell Template Prep Kit 2.0
snv Number	__DELETE__
SoLiD SAGE Kit	SoLiD SAGE Kit
Somascan	SomaScan
SomaScan	SomaScan
some additional fields	__DELETE__
SQK_LSK109	Ligation Sequencing Kit SQK-LSK109
SQK-LSK109	Ligation Sequencing Kit SQK-LSK109
SQK-LSK109 Kit	Ligation Sequencing Kit SQK-LSK109
SQK-LSK110	Ligation Sequencing Kit SQK-LSK110
SQK-LSK114	Ligation Sequencing Kit SQK-LSK114
SQK-LSK308	SQK-LSK308
SQK-Q20EA	SQK-Q20EA
Staining Kit for PhenoCycler	Staining Kit for PhenoCycler
Stranded Total RNA Prep, Ligation with Ribo-Zero Plus kit	Illumina Stranded Total RNA Prep, Ligation with Ribo-Zero Plus
Sure Select Human All Exon v5 kit	SureSelect Human All Exon V5
Sure Select XT Library Prep Kit	SureSelect XT Library Prep Kit
SureSelect	SureSelect Kit
SureSelect Clinical Research Panel v2	SureSelect Clinical Research Panel v2
SureSelect custom kit	SureSelect Custom Kit
SureSelect Custom Kit	SureSelect Custom Kit
SureSelect Custom Kit (SureSelect Human All Exon V5 + lincRNA)	SureSelect Human All Exon V5 + lincRNA
SureSelect Custom V5	SureSelect Custom V5
SureSelect Custom(v5)	SureSelect Custom V5
SureSelect Custom(v5n)	SureSelect Custom V5
SureSelect Exome V5 kit	SureSelect Human All Exon V5
SureSelect Human All Exon 50 Mb Kit	SureSelect Human All Exon 50Mb
SureSelect Human All Exon 50 Mb Kit(Agilent社)	SureSelect Human All Exon 50 Mb Kit(Agilent社)
SureSelect Human All Exon 50Mb	SureSelect Human All Exon 50Mb
SureSelect Human All Exon kit	SureSelect Human All Exon Kit
SureSelect Human All Exon Kit	SureSelect Human All Exon Kit
SureSelect Human ALL Exon kit	SureSelect Human All Exon Kit
SureSelect Human ALL Exon kit (50Mb kit, v4/v5)	SureSelect Human All Exon Kit
SureSelect Human All Exon kit v4	SureSelect Human All Exon V4
SureSelect Human All Exon Kit v4.0	SureSelect Human All Exon V4
SureSelect Human All Exon Kit v4.0 (Agilent Technologies)	SureSelect Human All Exon V4
SureSelect Human All Exon Kit V4/V5	SureSelect Human All Exon Kit
SureSelect Human All Exon kit v5	SureSelect Human All Exon V5
SureSelect Human All Exon Kit v5.0	SureSelect Human All Exon V5
SureSelect Human All Exon Kit v5.0 (Agilent Technologies)	SureSelect Human All Exon Kit v5.0 (Agilent Technologies)
SureSelect Human All Exon Kit V6	SureSelect Human All Exon V6
SureSelect Human All Exon V2	SureSelect Human All Exon V2
SureSelect Human All Exon V4	SureSelect Human All Exon V4
SureSelect Human All Exon V4 (Agilent)	SureSelect Human All Exon V4 (Agilent)
SureSelect Human All Exon V4 + lincRNA	SureSelect Human All Exon V4
SureSelect Human All Exon V4 + UTRs	SureSelect Human All Exon V4 + UTRs
SureSelect Human All Exon V4 Kit	SureSelect Human All Exon V4
SureSelect Human All Exon V4 or V5 plus lncRNA (Agilent)	SureSelect Human All Exon V5 + lincRNA
SureSelect Human All Exon V4+UTRs Kit	SureSelect Human All Exon V4 + UTRs
SureSelect Human All Exon v5	SureSelect Human All Exon V5
SureSelect Human All Exon V5	SureSelect Human All Exon V5
SureSelect Human ALL Exon V5	SureSelect Human All Exon V5
SureSelect Human All Exon V5 (Agilent)	SureSelect Human All Exon V5 (Agilent)
SureSelect Human All Exon V5 + lincRNA	SureSelect Human All Exon V5 + lincRNA
SureSelect Human All Exon V5 + lincRNA + Virus	SureSelect Human All Exon V5 + lincRNA + Virus
SureSelect Human All Exon V5 + UTRs	SureSelect Human All Exon V5 + UTRs
SureSelect Human All Exon V5 Kit	SureSelect Human All Exon V5
SureSelect Human ALL Exon V5 Kit	SureSelect Human All Exon V5
SureSelect Human All Exon V5(50 Mb)Kit	SureSelect Human All Exon V5
SureSelect Human All Exon V5+UTRs	SureSelect Human All Exon V5 + UTRs
SureSelect Human All Exon V5+UTRs Kit	SureSelect Human All Exon V5 + UTRs
SureSelect Human All Exon v6	SureSelect Human All Exon V6
SureSelect Human All Exon V6	SureSelect Human All Exon V6
SureSelect Human All Exon v6 (Agilent Technologies)	SureSelect Human All Exon v6 (Agilent Technologies)
SureSelect Human All Exon V6 (Agilent Technologies)	SureSelect Human All Exon V6
SureSelect Human All Exon V6 kit	SureSelect Human All Exon V6
SureSelect Human All Exon V6 Kit	SureSelect Human All Exon V6
SureSelect Human All Exon V6r2	SureSelect Human All Exon V6r2
SureSelect Human All Exon V6r2+lncRNA+mtDNA	SureSelect Human All Exon V6r2
SureSelect Human All Exon V7	SureSelect Human All Exon V7
SureSelect Human All Exon v7 (Agilent Technologies)	SureSelect Human All Exon v7 (Agilent Technologies)
SureSelect Human All Exon V7 (Agilent Technologies)	SureSelect Human All Exon V7 (Agilent Technologies)
SureSelect Human All Exon V7 Kit	SureSelect Human All Exon V7
SureSelect Human AllExon V6	SureSelect Human All Exon V6
SureSelect Kit	SureSelect Kit
SureSelect NCC oncopanel	SureSelect NCC Oncopanel
SureSelect NCC Oncopanel	SureSelect NCC Oncopanel
SureSelect QXT Human All Exon V5	SureSelect QXT Human All Exon V5
SureSelect strand specific RNA	SureSelect Strand Specific RNA Kit
SureSelect Strand Specific RNA kit	SureSelect Strand Specific RNA Kit
SureSelect Strand Specific RNA Kit	SureSelect Strand Specific RNA Kit
SureSelect Strand Specific RNA Library Preparation Kit for Illumina	SureSelect Strand Specific RNA Kit
SureSelect Strand Specific RNA Library Preparation Kit for Illumina(Agilent Technologies)	SureSelect Strand Specific RNA Library Preparation Kit for Illumina(Agilent Technologies)
SureSelect Strand-Specific RNA Library Prep Kit	SureSelect Strand Specific RNA Kit
SureSelect Target Enrichment System	SureSelect Target Enrichment System
SureSelect Target Enrichment System Human All Exon V2	SureSelect Human All Exon V2
SureSelect V7 (Agilent) (9 samples)	SureSelect V7 (Agilent) (9 samples)
SureSelect ver. 5 NEBNext Ultra DNA Library Prep Kit for Illumina	SureSelect Human All Exon V5
SureSelect XT	SureSelect XT
SureSelect XT + KAPA Hyper Prep	SureSelect XT + KAPA Hyper Prep
SureSelect XT Custom	SureSelect XT Custom Kit
SureSelect XT custom capture library	SureSelect XT Custom Kit
SureSelect XT Custom Kit	SureSelect XT Custom Kit
SureSelect XT Exome V5 Custom kit	SureSelect XT Human All Exon V5
SureSelect XT Focused Exome Kit	SureSelect XT Focused Exome Kit
SureSelect XT HS	SureSelect XT HS
SureSelect XT HS Target Enrichment System	SureSelect XT HS
SureSelect XT HS V5	SureSelect XT HS V5
SureSelect XT HS V5 (Agilent Technologies)	SureSelect XT HS V5
SureSelect XT HS2 RNA Reagent Kit	SureSelect XT HS2 RNA Reagent Kit
SureSelect XT Human All Exon	SureSelect XT Human All Exon Kit
SureSelect XT Human All Exon Kit	SureSelect XT Human All Exon Kit
SureSelect XT Human All Exon system	SureSelect XT Human All Exon Kit
SureSelect XT Human All Exon V5	SureSelect XT Human All Exon V5
SureSelect XT Human All Exon V5 + IncRNA kit	SureSelect XT Human All Exon V5 + lincRNA
SureSelect XT Human All Exon V5 + lincRNA	SureSelect XT Human All Exon V5 + lincRNA
SureSelect XT Human All Exon V5+lncRNA	SureSelect XT Human All Exon V5 + lincRNA
SureSelect XT Human All Exon V6	SureSelect XT Human All Exon V6
SureSelect XT Human All Exon V6 Kit	SureSelect XT Human All Exon V6
SureSelect XT Human All Exon V7	SureSelect XT Human All Exon V7
SureSelect XT Human All Exon V7 kit	SureSelect XT Human All Exon V7
SureSelect XT Kit	SureSelect XT Kit
SureSelect XT Library Prep Kit	SureSelect XT Library Prep Kit
SureSelect XT library preparation kit	SureSelect XT Library Prep Kit
SureSelect XT Low Input	SureSelect XT Low Input Kit
SureSelect XT Low Input Kit	SureSelect XT Low Input Kit
SureSelect XT Methyl-Seq	SureSelect XT Methyl-Seq
SureSelect XT reagent KAPA Hyper Prep kit	SureSelect XT + KAPA Hyper Prep
SureSelect XT Reagent Kit	SureSelect XT Kit
SureSelect XT REAGENT KIT	SureSelect XT Kit
SureSelect XT Reagents	SureSelect XT Kit
SureSelect XT RNA Target Enrichment	SureSelect XT RNA Target Enrichment
SureSelect XT RNA Target Enrichment for Illumina Multiplexed Sequencing	SureSelect XT RNA Target Enrichment
SureSelect XT Target Enrichment	SureSelect XT Target Enrichment
SureSelect XT2 Custom Kit	SureSelect XT2 Custom Kit
SureSelect/HaloPlex Target Enrichment System	SureSelect/HaloPlex Target Enrichment System
SureSelectXT Custom 1kb-499kb (Agilent Technologies)	SureSelect XT Custom Kit
SureSelectXT Custom kit	SureSelect XT Custom Kit
SureSelectXT HS Target Enrichment System	SureSelect XT HS
SureSelectXT Human All Exon Kit V5	SureSelect XT Human All Exon V5
SureSelectXT Human All Exon kit V6	SureSelect XT Human All Exon V6
SureSelectXT Kit	SureSelect XT Kit
SureSelectXT Library Prep Kit	SureSelect XT Library Prep Kit
SureSelectXT Reagent kit	SureSelect XT Kit
SureSelectXT Reagent Kit	SureSelect XT Kit
SureSelectXT Target Enrichment System	SureSelect XT Target Enrichment
SureSlect XT Custom	SureSelect XT Custom Kit
SureTag Complete DNA Labeling Kit	SureTag Complete DNA Labeling Kit
TACS ligation-mediated PBAT*ref1	TACS ligation-mediated PBAT*ref1
TACS-T4	TACS-T4
Tagment DNA TDE1 Enzyme and Buffer Kit	Tagment DNA TDE1 Kit
Tagment DNA TDE1 Kit	Tagment DNA TDE1 Kit
Takara Smarter kit	SMARTer Kit
TaqMan SNP Genotyping Assays	TaqMan SNP Genotyping Assays
the Big Dye Terminator FS ready-reaction kit (Applied Biosystems)	the Big Dye Terminator FS ready-reaction kit (Applied Biosystems)
the library prep. kit for SMRT sequencing by Pacific Biosciences	SMRT Library Prep Kit
The NEBNext Ultra DNA Library Prep Kit for Illumina	The NEBNext Ultra DNA Library Prep Kit for Illumina
Thermo Fisher Scientific ABsolute QPCR Mix	ABsolute QPCR Mix
Thermo Fisher Scientific TaqMan SNP Genotyping Assays	TaqMan SNP Genotyping Assays
Thru PLEX DNA-Seq Kit	ThruPLEX DNA-Seq Kit
ThruPLEX DNA-Seq Kit	ThruPLEX DNA-Seq Kit
ThruPLEX tag-seq	ThruPLEX Tag-Seq Kit
ThruPLEX Tag-Seq Kit	ThruPLEX Tag-Seq Kit
Total Number.	__DELETE__
TrueSeq DNA Sample Prep Kit v2, Set A	TruSeq DNA Sample Prep Kit v2
TrueSeq RNA Library Prep Kit	TrueSeq RNA Library Prep Kit
TrueSeq RNA library preparation	TruSeq RNA Library Prep Kit
TruSeq	TruSeq
TruSeq ChIP Sample Prep Kit	TruSeq ChIP Sample Prep Kit
TruSeq Custom Amplicon	TruSeq Custom Amplicon
TruSeq Custom Amplicon (TSCA) Library Prep Kit	TruSeq Custom Amplicon (TSCA) Library Prep Kit
TruSeq DNA LT Sample Prep Kit	TruSeq DNA LT Sample Prep Kit
TruSeq DNA Methylation Kit	TruSeq DNA Methylation Kit
TruSeq DNA Nano	TruSeq DNA Nano Kit
TruSeq DNA Nano kit	TruSeq DNA Nano Kit
TruSeq DNA Nano Kit	TruSeq DNA Nano Kit
TruSeq DNA PCR Free(350)	TruSeq DNA PCR-Free Kit
TruSeq DNA PCR-Free	TruSeq DNA PCR-Free Kit
TruSeq DNA PCR-Free High Throughput Library Prep Kit	TruSeq DNA PCR-Free Kit
TruSeq DNA PCR-Free HT Library Prep Kit	TruSeq DNA PCR-Free Kit
TruSeq DNA PCR-Free HT sample prep kit	TruSeq DNA PCR-Free Kit
TruSeq DNA PCR-Free HT Sample Prep Kit	TruSeq DNA PCR-Free Kit
TruSeq DNA PCR-Free Kit	TruSeq DNA PCR-Free Kit
TruSeq DNA PCR-free Library Prep kit	TruSeq DNA PCR-Free Kit
TruSeq DNA PCR-free Library Prep Kit	TruSeq DNA PCR-Free Kit
TruSeq DNA PCR-Free Library prep kit	TruSeq DNA PCR-Free Kit
TruSeq DNA PCR-Free Library Prep kit	TruSeq DNA PCR-Free Kit
TruSeq DNA PCR-Free Library Prep Kit	TruSeq DNA PCR-Free Kit
TruSeq DNA PCR-free Library Preparation kit	TruSeq DNA PCR-Free Kit
TruSeq DNA PCR-Free Library Preparation Kit	TruSeq DNA PCR-Free Kit
TruSeq DNA PCR-Free LT Library Prep Kit	TruSeq DNA PCR-Free Kit
TruSeq DNA PCR-Free Prep kit	TruSeq DNA PCR-Free Kit
TruSeq DNA PCR-Free Sample Prep Kit	TruSeq DNA PCR-Free Kit
TruSeq DNA PCR‑Free Library Prep Kit	TruSeq DNA PCR‑Free Library Prep Kit
TruSeq DNA Sample Prep kit	TruSeq DNA Sample Prep Kit
TruSeq DNA Sample Prep Kit	TruSeq DNA Sample Prep Kit
TruSeq DNA Sample Prep Kit v2	TruSeq DNA Sample Prep Kit v2
TruSeq Exome Library Prep Kit	TruSeq Exome Library Prep Kit
TruSeq Nano DNA HT Sample Prep Kit	TruSeq Nano DNA Kit
TruSeq Nano DNA Kit	TruSeq Nano DNA Kit
TruSeq Nano DNA Library Prep kit	TruSeq Nano DNA Kit
TruSeq Nano DNA Library Prep Kit	TruSeq Nano DNA Kit
TruSeq Nano DNA Library Preparation Kit	TruSeq Nano DNA Kit
TruSeq Nano DNA Library Prepkit	TruSeq Nano DNA Kit
TruSeq Nano DNA Low Throughput Library Prep Kit	TruSeq Nano DNA Kit
TruSeq Nano DNA LT Sample Prep Kit	TruSeq Nano DNA Kit
TruSeq Nano DNA Sample Preparation Kit	TruSeq Nano DNA Kit
TruSeq RNA Access Library Prep kit	TruSeq RNA Access Library Prep Kit
TruSeq RNA Access Library Prep Kit	TruSeq RNA Access Library Prep Kit
TruSeq RNA CD Index Kit (Dual Index)	TruSeq RNA CD Index Kit (Dual Index)
TruSeq RNA Exome kit	TruSeq RNA Exome Kit
TruSeq RNA Exome Kit	TruSeq RNA Exome Kit
TruSeq RNA Library Prep Kit	TruSeq RNA Library Prep Kit
TruSeq RNA Library Prep Kit v2	TruSeq RNA Library Prep Kit v2
TruSeq RNA Library Prep Kit v2 TruSeq Stranded mRNA Library Prep Kit	TruSeq RNA Library Prep Kit v2 TruSeq Stranded mRNA Library Prep Kit
TruSeq RNA Library Preparation Kit v2	TruSeq RNA Library Prep Kit v2
TruSeq RNA LT Sample Prep Kit	TruSeq RNA Library Prep Kit
TruSeq RNA Sample Prep Kit	TruSeq RNA Library Prep Kit
TruSeq RNA Sample Prep Kit v2	TruSeq RNA Library Prep Kit v2
TruSeq RNA Sample Preparation Kit v2	TruSeq RNA Library Prep Kit v2
TruSeq RNA sample Preparation KitV2	TruSeq RNA Library Prep Kit v2
TruSeq RNA Sample Preparation v2	TruSeq RNA Library Prep Kit v2
TruSeq RNA Sample Preparation v2 Guide, Part # 15026495	TruSeq RNA Library Prep Kit v2
TruSeq Small RNA Library Prep Kit	TruSeq Small RNA Library Prep Kit
TruSeq Stranded mRNA	TruSeq Stranded mRNA Kit
TruSeq stranded mRNA Kit	TruSeq Stranded mRNA Kit
TruSeq Stranded mRNA kit	TruSeq Stranded mRNA Kit
TruSeq Stranded mRNA Kit	TruSeq Stranded mRNA Kit
TruSeq Stranded mRNA Library Prep	TruSeq Stranded mRNA Kit
TruSeq Stranded mRNA Library prep kit	TruSeq Stranded mRNA Kit
TruSeq Stranded mRNA Library Prep Kit	TruSeq Stranded mRNA Kit
TruSeq Stranded mRNA Library Prep Kit (Illumina)	TruSeq Stranded mRNA Library Prep Kit (Illumina)
TruSeq Stranded mRNA Library Prep Kits	TruSeq Stranded mRNA Kit
TruSeq Stranded mRNA LT Sample Prep Kit	TruSeq Stranded mRNA Kit
TruSeq Stranded mRNA Prep kit	TruSeq Stranded mRNA Kit
TruSeq Stranded mRNA Prep Kit	TruSeq Stranded mRNA Prep Kit
TruSeq Stranded mRNA Sample Prep kit	TruSeq Stranded mRNA Kit
TruSeq Stranded mRNA Sample Prep Kit	TruSeq Stranded mRNA Kit
TruSeq Stranded Total RNA Kit	TruSeq Stranded Total RNA Kit
TruSeq Stranded Total RNA Kit with Ribo-Zero	TruSeq Stranded Total RNA Kit with Ribo-Zero
TruSeq Stranded Total RNA Kit with Ribo-Zero Globin	TruSeq Stranded Total RNA Kit with Ribo-Zero Globin
TruSeq Stranded Total RNA Kit with Ribo-Zero Gold	TruSeq Stranded Total RNA Kit with Ribo-Zero Gold
TruSeq Stranded Total RNA Library Prep	TruSeq Stranded Total RNA Library Prep
TruSeq Stranded Total RNA Library Prep Gold	TruSeq Stranded Total RNA Kit with Ribo-Zero Gold
TruSeq Stranded Total RNA Library Prep Gold Kit	TruSeq Stranded Total RNA Kit with Ribo-Zero Gold
TruSeq Stranded Total RNA Library Prep Kit	TruSeq Stranded Total RNA Kit
TruSeq Stranded Total RNA Library Prep Kit (Illumina)	TruSeq Stranded Total RNA Library Prep Kit (Illumina)
TruSeq Stranded Total RNA Library Prep kit with Ribo-Zero Human/Mouse/Rat	TruSeq Stranded Total RNA Kit with Ribo-Zero
TruSeq Stranded Total RNA Library Prep Kit with Ribo‑Zero Gold (Illumina)	TruSeq Stranded Total RNA Library Prep Kit with Ribo‑Zero Gold (Illumina)
TruSeq Stranded Total RNA with Ribo-Zero Globin	TruSeq Stranded Total RNA Kit with Ribo-Zero Globin
TruSeq Stranded Total RNA with ribo-zero gold	TruSeq Stranded Total RNA Kit with Ribo-Zero Gold
TruSeq® DNA PCR-Free Sample Prep Kit	TruSeq® DNA PCR-Free Sample Prep Kit
TruSight Exome Kit	TruSight Exome Kit
TruSight Myeloid Sequencing Panel	TruSight Myeloid Sequencing Panel
Twist Comprehenive exome	Twist Comprehensive Exome
Twist Comprehensive Exome	Twist Comprehensive Exome
Twist Comprehensive Exome Kit	Twist Comprehensive Exome
Twist Comprehensive Exome Panel	Twist Comprehensive Exome
Twist Custom Panels	Twist Custom Panels
Twist Library Preparation EF kit	Twist Library Preparation EF Kit
Twist Library Preparation EF Kit	Twist Library Preparation EF Kit
Twist library preparation kit	Twist Library Preparation Kit
Twist Library Preparation Kit	Twist Library Preparation Kit
Twist Standard Hyb and Wash Kit v2	Twist Standard Hyb and Wash Kit v2
UK BiLEVE Axiom Array	UK BiLEVE Axiom Array
UK Biobank Axiom Array	UK Biobank Axiom Array
Ultra-Long DNA Sequencing Kit	Ultra-Long DNA Sequencing Kit
Ultra-Long DNA Sequencing Kit (SQK-ULK001)	Ultra-Long DNA Sequencing Kit
Ultra-Long Sequencing Kit (SQK-ULK001)	Ultra-Long DNA Sequencing Kit
VariantPlex	VariantPlex
Visium CytAssist Spatial Gene Expression for FFPE	Visium CytAssist Spatial Gene Expression for FFPE
Visium CytAssist Spatial Gene Expression for FFPE, Human Transcriptome	Visium CytAssist Spatial Gene Expression for FFPE
Visium CytAssist Spatial Gene Expression for FFPE, human transcriptome probe kit	Visium CytAssist Spatial Gene Expression for FFPE
Visium Gene Expression Kit	Visium Gene Expression Reagent Kit
Visium Human Transcriptome Probe Kit	Visium Human Transcriptome Probe Kit
Visium Spatial for FFPE Gene Expression Kit	Visium Spatial Gene Expression for FFPE
Visium Spatial Gene Expression	Visium Spatial Gene Expression (unspecified sample type)
Visium Spatial Gene Expression for FFPE	Visium Spatial Gene Expression for FFPE
Visium Spatial Gene Expression for FFPE, human transcriptome probe kit	Visium Spatial Gene Expression for FFPE
Visium Spatial Gene Expression library preparation slide	Visium Spatial Gene Expression
Visium Spatial Gene Expression Reagent Kits	Visium Spatial Gene Expression
Visium Spatial Gene Expression Reagent Kits (10X Genomics)	Visium Spatial Gene Expression
Visium Spatial Gene Expression Reagent Kits for FFPE	Visium Spatial Gene Expression for FFPE
Visium Spatial Gene Expression Slide & Reagent Kit	Visium Spatial Gene Expression
Visium Spatial Gene Expression Slide and Reagent Kit	Visium Spatial Gene Expression
WAKFlow HLA typing kit	WAKFlow HLA Typing Kit
WAKFlow HLA Typing Kit	WAKFlow HLA Typing Kit
Xenium Decoding Consumables	Xenium Decoding Consumables
Xenium Decoding Reagents	Xenium Decoding Reagents
Xenium Human Multi-Tissue and Cancer Panel	Xenium Human Multi-Tissue and Cancer Panel
Xenium Slides & Sample Prep Reagents	Xenium Slides & Sample Prep Reagents
xGen custom-designed Gene Capture Pools (IDT)	xGen Gene Capture Pools
xGen Exome Research Panel	xGen Exome Research Panel
xGen Gene Capture Pools	xGen Gene Capture Pools
xGen Prism DNA Library Prep Kit	xGen Prism DNA Library Prep Kit
ZYMO Research EZ DNA Methylation-Gold Kit	EZ DNA Methylation-Gold Kit
