???	__DELETE__
...	__DELETE__
10x Genomics	10x Genomics
Affymetrix	Affymetrix
Agilent	Agilent
Agilent Technologies	Agilent
Akoya Biosciences	Akoya Biosciences
Applied BioSystem	Applied Biosystems
Applied Biosystems	Applied Biosystems
BGI	BGI
Bionano	Bionano
Bionano Genomics	Bionano Genomics
BioRad	BioRad
Bruker	Bruker
CNC	__DELETE__
DIONEX	DIONEX
Fluidigm	Fluidigm
Hologic Japan	Hologic Japan
I	__DELETE__
Illu	Illumina
illumina	Illumina
Illumina	Illumina
Illuminas	Illumina
Ion Total RNA-Seq Kit v2	__DELETE__
Life Technologies	Life Technologies
MGI	MGI
MGI Tech	MGI
MGI Technologies	MGI
Nanopore	Oxford Nanopore Technologies
NanoString Technologies	NanoString Technologies
Olink	Olink
Oxford Nanopore	Oxford Nanopore Technologies
Oxford Nanopore Technologies	Oxford Nanopore Technologies
PacBio	PacBio
Pacific Biosciences	PacBio
Perlegen Sciences	Perlegen Sciences
Qiagen	Qiagen
Roche	Roche
Sciex	Sciex
Single	__DELETE__
Somalogic	Somalogic
Thermo Fisher	Thermo Fisher Scientific
Thermo Fisher Scientific	Thermo Fisher Scientific
Vizgen	Vizgen
