...	__DELETE__
1.1.5.5	__DELETE__
1000 Genomes Project	1000 Genomes Project
??	__DELETE__
African	African
American	American
Asian	Asian
asian	Asian
AYA generation	__DELETE__
Balti	__DELETE__
Balti people	Balti people
British	British
C	__DELETE__
C0	__DELETE__
Canadian	Canadian
cell_line	__DELETE__
cell_type	__DELETE__
Chrysanthemum	__DELETE__
DESCRIPTION	__DELETE__
East Asian	East Asian
east asian	East Asian
European	European
Finnish	Finnish
H	__DELETE__
Han Chinese	Han Chinese
human	__DELETE__
J. H. G	__DELETE__
Japanese	Japanese
japanese	Japanese
japanese cohort of the genome Cohort Study of the Tohoku Medical Megabank Organization (ToMMo) 	Japanese
Japanese in Tokyo, Japan	Japanese
K-40.2	__DELETE__
Korean	Korean
M	__DELETE__
Mouse	__DELETE__
NBDC	__DELETE__
Other	Other
Ryukyu	Ryukyu
test	__DELETE__
Thai	Thai
TITLE	__DELETE__
UK	UK
UK population	British
Vietnamese	Vietnamese
White	White
WS(ICD10: Q253): 6 cases	__DELETE__
Z	__DELETE__
患者	__DELETE__
日本人	Japanese
